34 27
0 0 0 0 0 0 0 0 0 0 0 0 0 0 0 0 0 0 0 0 0 0 0 0 0 0 0 0 0 0 0 0 0 0
1 1 1 1 1 1 1 1 0 1 1 1 1 1 1 1 1 1 1 1 1 1 1 1 1 0 1 1 1 1 1 1 1 1
1 1 1 1 1 1 1 1 0 1 1 1 1 1 1 1 1 1 1 1 1 1 1 1 1 7 1 1 1 1 1 1 1 1
1 1 1 1 8 1 1 1 7 1 1 1 1 1 1 1 1 8 1 1 1 1 1 1 1 0 1 1 1 1 1 1 1 1
1 1 1 1 1 1 1 1 0 1 1 1 1 1 1 1 1 1 1 1 1 1 1 1 1 0 1 1 1 1 1 1 1 1
1 1 1 1 1 1 1 1 0 0 0 0 0 0 1 1 1 1 1 1 1 1 1 1 1 0 1 1 1 1 1 1 1 1
1 1 1 1 1 1 1 1 1 1 1 7 1 1 1 1 1 1 1 1 1 1 1 1 1 7 1 1 1 1 1 1 1 1
2 2 2 2 2 2 2 2 2 2 2 0 2 2 2 2 2 2 2 2 2 2 2 2 2 0 2 2 2 2 2 2 2 2
2 2 2 2 2 2 2 8 2 2 2 0 0 0 0 0 6 0 0 0 2 2 2 2 2 0 2 2 2 2 2 2 2 2
2 2 2 2 2 2 2 2 2 2 2 0 2 2 0 2 2 2 2 0 2 2 2 2 2 0 2 2 2 2 2 2 2 2
2 2 2 2 2 2 2 2 2 2 2 0 2 2 0 2 2 2 2 0 2 2 2 2 2 6 2 2 2 8 2 2 2 2
2 2 2 2 2 2 2 2 2 2 2 2 2 2 0 2 2 2 2 0 2 2 2 2 2 0 2 2 2 2 2 2 2 2
2 2 2 2 2 2 2 2 2 8 2 2 2 2 0 2 2 2 2 0 2 2 2 2 2 0 2 2 2 2 2 2 2 2
3 3 3 3 3 3 3 3 3 3 3 3 3 3 7 3 3 3 3 0 0 0 6 0 0 0 3 3 3 3 3 3 3 3
3 3 3 3 3 0 0 0 0 0 6 0 0 0 0 3 3 3 3 3 3 0 3 3 3 3 3 3 3 3 3 3 3 3
3 3 3 3 3 0 3 3 3 3 3 3 3 3 3 3 3 3 3 3 3 0 0 3 3 3 3 3 3 3 3 3 3 3
3 3 3 3 0 0 3 3 0 7 0 3 3 3 3 3 3 3 0 0 7 3 0 3 3 0 3 3 3 3 8 3 3 3
3 3 3 3 0 3 3 3 3 3 3 3 3 3 3 3 3 3 3 3 3 0 7 3 3 0 3 3 3 3 3 3 3 3
3 3 3 3 0 6 0 0 7 3 3 3 3 3 3 3 3 3 3 3 3 0 3 3 3 7 3 3 3 3 3 3 3 3
3 3 3 3 3 3 3 3 0 3 3 3 3 3 3 3 3 3 3 3 3 0 3 3 3 3 3 3 3 3 3 3 3 3
3 3 3 3 3 3 3 0 0 3 3 3 3 3 3 3 3 3 3 3 3 7 0 0 0 0 7 0 0 6 0 0 0 0
4 4 4 4 4 4 4 0 4 4 4 4 4 4 4 4 4 4 4 4 4 4 0 4 4 4 4 4 4 4 4 4 4 4
0 0 0 6 0 7 0 0 6 0 0 0 4 4 4 4 4 4 4 4 4 4 0 4 4 4 4 4 4 4 4 4 4 4
4 4 4 4 4 4 4 4 4 4 4 0 4 4 4 0 5 0 4 4 4 4 0 4 4 4 4 4 4 4 4 4 4 4
4 4 4 4 4 4 4 4 4 4 4 6 4 4 4 4 4 4 4 4 4 4 7 4 4 4 4 4 4 4 4 4 4 4
4 4 4 4 4 4 4 4 4 4 4 0 4 4 4 4 4 4 4 4 4 4 0 4 4 4 4 4 4 4 4 4 4 4
4 4 4 4 4 4 4 4 4 4 4 0 0 0 0 0 7 0 0 0 0 0 0 4 4 4 4 4 4 4 4 4 4 4